%%%%%
%P  %
% % %
%%% %
%.% %
%   %
%%%%%