%%%%%%%%%%
%P  %    %
% % % %% %
% %    % %
%  % %   %
%        %
% %%%% % %
%      %.%
%%%%%%%%%%